SO textures/BRICK_1A.xpm
EA textures/BRICK_2B.xpm
WE textures/BRICK_3D.xpm
DO textures/DOOR_4A.xpm
NO textures/BRICK_3B.xpm
NO textures/BRICK_3B.xpm

C 50,50,50
F 160,160,160

1111111111111111111111111
1000000000110000000000001
1011000001110000000000001
1001000000000000000000001
11111111101100001000001111
1000000000110000011101111
1111111111111011100000111
1111011111111101110101001
1000000011010101110000001
1000N0000000000000000001
1000000000000000110101001
1100000111010101111101111
1111011111101011011110101
1111111111111111111111111
