SO textures/south_wall.xpm
EA textures/east_wall.xpm
WE textures/west_wall.xpm
NO textures/north_wall.xpm

F 200,200,200
C 30,30,30

1111111111111111111111111
1000000000110000000000001
1011000001110000000000001
100100000000000000000000111111111
111111111011000001110000000000001
100000000011000001110111111111111
11110111111111011100000010001
11110111111111011101010010001
10000000110101011100000010001
10000000000000001100000010001
10000000000000001101010000001
11000001110101011111011111N1111
11110111 1110101 101111010101
11111111 1111111 111111111111